WWWWWWWWWWWWWWWWWWWWWWWWWWWWWW
WIIIIIWKIIIIIIIIIIWIDIWIIIIIIW
WIPIIIWWWWWIWWWIWWWIWIWWIWWWFW
WIIIIIIIIIIIWIIIIIIIWIIIIIIWIW
WWWWWWWWWWWWWWWWWWWWWWWWWWWWWW