WWWWWWWWWWWWWWWWWWWWWWWWWWWWWW
WIIIIIWIIIIIIIIWIIIKWIIWIIIIIW
WIPIIWWIWWIIWIIWIWWWWIIDIIIFIW
WIIIIIIIIWIIWIIIIIIIIIIWIIIIIW
WWWWWWWWWWWWWWWWWWWWWWWWWWWWWW